15 12
###############
#.#.........###
#.#.########..#
#.#....#...#..#
#.###..#.#.#..#
#...####.#.#..#
#.#.#..#.#.#.##
#.#.#.##.#.#..#
#...o....#.#.##
###.......##..#
#............X#
###############
